+-+-+-+-+-+-+-+-+-+-+
|                   |
+ +-+ +-+ + + + + + +
|         |         |
+ +-+-+-+-+ +-+-+ +-+
|         |   |     |
+-+-+ + + + + + +-+ +
|                   |
+-+-+-+-+ +-+-+-+ + +
|         |     |   |
+ +-+-+-+-+ +-+ + +-+
|            X       
+ + + + + + + + + + +
|                   |
+-+-+-+-+-+-+-+-+-+-+
