+-+-+-+-+-+-+-+-+-+-+-+-+-+-+-+-+-+-+-+-+
|                   |                   |
+ +-+ +-+ + + + + + + +-+ +-+ + + + + + +
|         |                   |         |
+ +-+-+-+-+ +-+-+ +-+ +-+-+-+-+ +-+-+ +-+
|         |   |     |         |   |     |
+-+-+ + + + + + +-+ +-+-+ + + + + + +-+ +
|                   |                   |
+-+-+-+-+ +-+-+-+ + +-+-+-+-+ +-+-+-+ + +
|         |     |   |         |     |   |
+ +-+-+-+-+ +-+ + +-+ +-+-+-+-+ +-+ + +-+
|                   |            |      |
+ + + + + + + + + + + + + + + + + + + + +
|                   |                   |
+-+-+-+-+-+-+-+ +-+-+-+-+-+-+-+-+-+ +-+-+
|                   |                   |
+ +-+ +-+ + + + + + + +-+ +-+ + + + + + +
|         |         |         |         |
+ +-+-+-+-+ +-+-+ +-+ +-+-+-+-+ +-+-+ +-+
|         |   |     |         |   |     |
+-+-+ + + + + + +-+ +-+-+ + + + + + +-+ +
|                   |                   |
+-+-+-+-+ +-+-+-+ + +-+-+-+-+ +-+-+-+ + +
|         |     |   |         |     |   |
+ +-+-+-+-+ +-+ + +-+ +-+-+-+-+ +-+ + +-+
|                   |                    
+ + + + + + + + + + + + + + + + + + + + +
|                   |                   |
+-+-+-+-+-+-+-+-+ +-+-+-+-+-+-+-+-+-+-+ +
|                   |                   |
+ +-+ +-+ + + + + + + +-+ +-+ + + + + + +
|         |                   |         |
+ +-+-+-+-+ +-+-+ +-+ +-+-+-+-+ +-+-+ +-+
|         |   |     |         |   |     |
+-+-+ + + + + + +-+ +-+-+ + + + + + +-+ +
|                   |                   |
+-+-+-+-+ +-+-+-+ + +-+-+-+-+ +-+-+-+ + +
|         |     |   |         |     |   |
+ +-+-+-+-+ +-+ + +-+ +-+-+-+-+ +-+ + +-+
|                   |            |      |
+ + + + + + + + + + + + + + + + + + + + +
|                   |                   |
+-+-+-+-+-+-+-+ +-+-+-+-+-+-+-+-+-+ +-+-+
|                   |                   |
+ +-+ +-+ + + + + + + +-+ +-+ + + + + + +
|         |         |         |         |
+ +-+-+-+-+ +-+-+ +-+ +-+-+-+-+ +-+-+ +-+
|         |   |     |         |   |     |
+-+-+ + + + + + +-+ +-+-+ + + + + + +-+ +
|                   |                   |
+-+-+-+-+ +-+-+-+ + +-+-+-+-+ +-+-+-+ + +
|         |     |   |         |     |   |
+ +-+-+-+-+ +-+ + +-+ +-+-+-+-+ +-+ + +-+
|                   |                   |
+ + + + + + + + + + + + + + + + + + + + +
|                   |                   |
+-+-+-+-+-+-+-+-+-+-+-+-+-+-+ +-+-+-+-+-+
|                   |                   |
+ +-+ +-+ + + + + + + +-+ +-+ + + + + + +
|         |                   |         |
+ +-+-+-+-+ +-+-+ +-+ +-+-+-+-+ +-+-+ +-+
|         |   |     |         |   |     |
+-+-+ + + + + + +-+ +-+-+ + + + + + +-+ +
|                   |                   |
+-+-+-+-+ +-+-+-+ + +-+-+-+-+ +-+-+-+ + +
|         |     |   |         |     |   |
+ +-+-+-+-+ +-+ + +-+ +-+-+-+-+ +-+ + +-+
|                   |            |      |
+ + + + + + + + + + + + + + + + + + + + +
|                   |                   |
+-+-+-+-+-+-+-+ +-+-+-+-+-+-+-+-+-+ +-+-+
|                   |                   |
+ +-+ +-+ + + + + + + +-+ +-+ + + + + + +
|         |         |         |         |
+ +-+-+-+-+ +-+-+ +-+ +-+-+-+-+ +-+-+ +-+
|         |   |     |         |   |     |
+-+-+ + + + + + +-+ +-+-+ + + + + + +-+ +
|                   |                   |
+-+-+-+-+ +-+-+-+ + +-+-+-+-+ +-+-+-+ + +
|         |     |   |         |     |   |
+ +-+-+-+-+ +-+ + +-+ +-+-+-+-+ +-+ + +-+
|                   |                   |
+ + + + + + + + + + + + + + + + + + + + +
|                   |                   |
+-+-+-+-+-+-+-+-+ +-+-+-+-+-+-+-+-+-+-+ +
|                   |                   |
+ +-+ +-+ + + + + + + +-+ +-+ + + + + + +
|         |                   |         |
+ +-+-+-+-+ +-+-+ +-+ +-+-+-+-+ +-+-+ +-+
|         |   |     |         |   |     |
+-+-+ + + + + + +-+ +-+-+ + + + + + +-+ +
|                   |                   |
+-+-+-+-+ +-+-+-+ + +-+-+-+-+ +-+-+-+ + +
|         |     |   |         |     |   |
+ +-+-+-+-+ +-+ + +-+ +-+-+-+-+ +-+ + +-+
|                   |            |      |
+ + + + + + + + + + + + + + + + + + + + +
|                   |                   |
+-+-+-+-+-+-+-+ +-+-+-+-+-+-+-+-+-+ +-+-+
|                   |                   |
+ +-+ +-+ + + + + + + +-+ +-+ + + + + + +
|         |         |         |         |
+ +-+-+-+-+ +-+-+ +-+ +-+-+-+-+ +-+-+ +-+
|         |   |     |         |   |     |
+-+-+ + + + + + +-+ +-+-+ + + + + + +-+ +
|                   |                   |
+-+-+-+-+ +-+-+-+ + +-+-+-+-+ +-+-+-+ + +
|         |     |   |         |     |   |
+ +-+-+-+-+ +-+ + +-+ +-+-+-+-+ +-+ + +-+
|            X      |                   |
+ + + + + + + + + + + + + + + + + + + + +
|                   |                   |
+-+-+-+-+-+-+-+-+-+-+-+-+-+-+-+-+-+-+-+-+
