+-+-+-+-+-+-+-+-+-+-+
|X                  |
+ + + + + + + + + + +
| |                 |
+ + + + + + + + +-+-+
| |                  
+-+ + + + + + + + + +
|                   |
+-+-+-+-+-+-+-+-+-+-+
