+-+-+-+-+-+-+-+-+-+-+
|                   |
+ + + + + + + + + + +
|                   |
+-+ + + + + + + + +-+
|X|                  
+ + + + + + + + + + +
|                   |
+-+-+-+-+-+-+-+-+-+-+
