+-+-+-+-+-+-+-+-+-+-+
|                   |
+ +-+ +-+ + + + + + +
|         |         |
+-+-+-+-+-+-+-+-+ +-+
|             |     |
+-+-+-+ +-+-+ + +-+ +
|X                  |
+-+-+-+-+ + +-+-+ + +
|     |   |     |   |
+ +-+-+-+-+ +-+ + +-+
|                   |
+ + + + + + + + + + +
|                   |
+-+-+-+-+-+-+-+-+-+-+
