+-+-+-+-+-+-+-+-+-+-+
|X                  |
+-+-+-+-+ + + + + + +
|         |         |
+ +-+-+-+-+ +-+-+ +-+
|                   |
+-+ + + + + + + + + +
|                   |
+-+-+-+-+ + + + + + +
|         |         |
+ +-+-+-+-+ +-+-+-+-+
|                   |
+-+ + + + + + + + + +
|                    
+-+-+-+-+-+-+-+-+-+-+
