+-+-+-+-+-+-+-+-+-+-+
|X  |   |     |   | |
+-+ + + + + + +-+-+ +
|   | |   | |   |   |
+ +-+-+ +-+-+-+ +-+ +
|       |     | |    
+ + +-+-+ + + + + +-+
|         |   |   | |
+-+-+-+-+-+-+-+-+-+-+
